1111111111111111111111
110EC0000C0000C000C001
1001000000000001000001
10C0000000000000000011
100000000C0000000000C1
100C000000P00000C01011
1000000C00000000001001
1000C00000C00000000001
1111111111111111111111
